Prologue:

Last night, while walking down the lonely sidewalk to your house, you notice farther down the street is your neighbor, Ms. Light, sitting alone on a sidewalk bench. You always felt sorry for the old woman (she looked about a hundred years old), because she's both blind and a widow. You didn't know much else about her. Everyone in town know's she's crazy, though. She hardly left her house after all, which made her being there even more strange. Ms. Light had no friends, and she was always singing a disturbing song quietly to herself.

You walked as quitely as possible to not disturb her (she was singing again). When, all of a sudden, Ms. Light stopped singing and turned her head slowly in your direction, acknowledging your presence. She heard you from over 30 meters away! Maybe she had smelled you? Or maybe she had sensed your presence, and knew that you had tried to avoid her? Whatever it was, you had to admit that Ms. Light's ESP was more than a little creepy.

Before you could even say anything, Ms. Light rose from her bench, and strode towards you at a startling pace. Once she was in considerable distance from you (much too close for your own comfort), she uttered in a low, scratchy voice, "Ah, I've been waiting for you. I'm going out of town tomorrow night, and I need you to watch my house for me...

Lights Out
An Interactive Fiction by Lee-Won Fulbright
Release 1 / Serial number 141005 / Inform 7 build 6L38 (I6/v6.33 lib 6/12N) SD

ms light's driveway
You were in need of a little bit of cash, and, though you were hesitant, agreed to house-sit for Ms. Light while she's out of town. It's weird though, hardly anyone travels this time of year, and Ms. Light is the last person you'd think would want a night away from home.

It's storming tonight. You are currently getting rained on. Better get out of the rain right away. You should take a quick look at Miss Light's house for the first time.

>x house
Ms. Light's tiny house at the end of the culdesac looks about as decrepit and off-putting as she does. You are a bit nervous as you have never been inside before. Go North through Front Door and into Entrance-Room.

>n
Entrance-Room
 You have opened the front door and are in the house's first room. You turn on the light-switch, but the lights fail to come on. You realize that the power must have gone out sometime during the storm! It's too dark to see*, so you can't tell what's in the room or what it is used for. You need to find a way to turn the lights back on.

You know that in every house in your neighborhood there is usually a basement containing a back-up generator for power outages during storms like this one. If you can find the generator, it should be fairly simple to get the power back on. However, there might be a code or password needed to activate it.

*NOTE: It is very important to understand that the house is completely dark. You will not be able to obtain all clues and have a full game experience unless you use ALL/MOST OF YOUR SENSES to interact with each thing/room. Also: While it is possible to "smell" or "listen to" a room without specifying object, you cannot "feel" a room. You must "feel" or "touch" specified objects within a room. Smells and sounds of objects can also be different from the room they are located in.

You know that  North is North-Room and East is East-Room. South is Ms. Light's Driveway.

>n
North room
You can't see much of the north room in this darkness. However, the floor is slick with a cold liquid. You have found a Wide Container in the middle of the room.

>x wide container
A wide, open container. It feels like it was made to be filled with something. It is empty. You can feel a handle on the wide container.

>x handle
You see nothing special about Handle.

>listen
You can hear a dripping noise coming from a wide container. Also, you hear faint footsteps coming from another room in the house.

>smell
You notice an odd metallic smell coming from somewhere in the room.

>s
Entrance Room
You have opened the front door and are in the house's first room. As you reach to the side of the door for the lights and flip the switch, you realize that the power must have gone out sometime during the storm. It's too dark to see, so you can't tell what the purpose of the room is. You need to find a way to turn the lights back on.

You know that in every house in your neighborhood there is usually a basement containing a back-up generator for power outages during storms like this one. If you can find the generator, it should be fairly simple to get the power back on. However, there might be a code or password needed to activate it.

For now, you can try navigate your way through the house by going North and East.

>e
East room
Going East, you travel down a flight of stairs. You assume that you must be in the basement. The generator should be in here somewhere.

>l
East room
Going East, you travel down a flight of stairs. You assume that you must be in the basement. The generator should be in here somewhere.

>listen
At first the room is completely silent. Then, out of nowhere you hear a single high-pitched sound coming from the middle of the room. It definitely sounds like a piano.

>x piano
Play something! (specific notes)

>feel
What do you want to feel?

>touch
What do you want to touch?

>feel east room
I only understood you as far as wanting to feel east.

>touch east room
I only understood you as far as wanting to touch east.

>w
Entrance Room
You have opened the front door and are in the house's first room. As you reach to the side of the door for the lights and flip the switch, you realize that the power must have gone out sometime during the storm. It's too dark to see, so you can't tell what the purpose of the room is. You need to find a way to turn the lights back on.

You know that in every house in your neighborhood there is usually a basement containing a back-up generator for power outages during storms like this one. If you can find the generator, it should be fairly simple to get the power back on. However, there might be a code or password needed to activate it.

For now, you can try navigate your way through the house by going North and East.

>listen
You hear the muffled sound of the rain outside. Then, what sounded like quick footsteps moving somewhere below you. Maybe you just imagined it.

>smell
A faint smell of mildew lingers. You smell something else, too-- animal hair? It seems to be coming from a Large Object in the middle of the room.

>x large object
A large object. It's hard to examine it using only sight in this darkness.

>touch large object
The large object is almost twice as big as you. It's soft and cushy. You bumped into a hard object next to the large object.

>x hard object
A large object. It's hard to examine it using only sight in this darkness.

>feel
What do you want to feel?

>feel hard object
After examining the hard object through touch, you have discovered that it has a square, flat surface that is parallel to the ground. On the surface is a small box.

>x box
An object that's in the shape of a box. It's hard to examine it using only sight in this darkness.

>feel box
You feel a small switch on the side of the box.

>pull switch
You flip the switch and you hear an audio recording being emitted from the box. The recording was low quality, and you strained to hear it. A bone-chilling music piece begins to play from what sounds like a piano. The unknown vocalist sings about drowning in a bathtub along to a sad melody. "Turn the faucet," the ghastly voice croons. Did Ms. Light compose this?

>x inventory
You can't see any such thing.

>inventory
You are carrying nothing.

>look
Entrance Room
You have opened the front door and are in the house's first room. As you reach to the side of the door for the lights and flip the switch, you realize that the power must have gone out sometime during the storm. It's too dark to see, so you can't tell what the purpose of the room is. You need to find a way to turn the lights back on.

You know that in every house in your neighborhood there is usually a basement containing a back-up generator for power outages during storms like this one. If you can find the generator, it should be fairly simple to get the power back on. However, there might be a code or password needed to activate it.

For now, you can try navigate your way through the house by going North and East.

>n
North room
You can't see much of the north room in this darkness. However, the floor is slick with a cold liquid. You have found a Wide Container in the middle of the room.

* * *

>x wide container
A wide, open container. It feels like it was made to be filled with something. It is empty. You can feel a handle on the wide container.

>x puddle
A cold liquid lines the floor. It's slippery.

>smell
You notice an odd metallic smell coming from somewhere in the room.

>listen
You can hear a dripping noise coming from a wide container. Also, you hear faint footsteps coming from another room in the house.

>turn the handle
Nothing obvious happens.

>pull handle
Nothing obvious happens.

>push handle
A cold liquid empties into the wide container. At the same time, you can hear a series of music notes being played from the wide container. You recognize the notes to be (in this order): C, A, G, E, D.

>s
Entrance Room
You have opened the front door and are in the house's first room. As you reach to the side of the door for the lights and flip the switch, you realize that the power must have gone out sometime during the storm. It's too dark to see, so you can't tell what the purpose of the room is. You need to find a way to turn the lights back on.

You know that in every house in your neighborhood there is usually a basement containing a back-up generator for power outages during storms like this one. If you can find the generator, it should be fairly simple to get the power back on. However, there might be a code or password needed to activate it.

For now, you can try navigate your way through the house by going North and East.

* * *

>e
East room
Going East, you travel down a flight of stairs. You assume that you must be in the basement. The generator should be in here somewhere.

>n
You can't go that way.

>w
Entrance Room
You have opened the front door and are in the house's first room. As you reach to the side of the door for the lights and flip the switch, you realize that the power must have gone out sometime during the storm. It's too dark to see, so you can't tell what the purpose of the room is. You need to find a way to turn the lights back on.

You know that in every house in your neighborhood there is usually a basement containing a back-up generator for power outages during storms like this one. If you can find the generator, it should be fairly simple to get the power back on. However, there might be a code or password needed to activate it.

For now, you can try navigate your way through the house by going North and East.

>n
North room
You can't see much of the north room in this darkness. However, the floor is slick with a cold liquid. You have found a Wide Container in the middle of the room.

>e
You can't go that way.

>s
Entrance Room
You have opened the front door and are in the house's first room. As you reach to the side of the door for the lights and flip the switch, you realize that the power must have gone out sometime during the storm. It's too dark to see, so you can't tell what the purpose of the room is. You need to find a way to turn the lights back on.

You know that in every house in your neighborhood there is usually a basement containing a back-up generator for power outages during storms like this one. If you can find the generator, it should be fairly simple to get the power back on. However, there might be a code or password needed to activate it.

For now, you can try navigate your way through the house by going North and East.

>listen
You hear the muffled sound of the rain outside. Then, what sounded like quick footsteps moving somewhere below you. Maybe you just imagined it.

* * *

>smell
A faint smell of mildew lingers. You smell something else, too-- animal hair? It seems to be coming from a Large Object in the middle of the room.

>w
You can't go that way.

>e
East room
Going East, you travel down a flight of stairs. You assume that you must be in the basement. The generator should be in here somewhere.

>listen
At first the room is completely silent. Then, out of nowhere you hear a single high-pitched sound coming from the middle of the room. It definitely sounds like a piano.

>touch piano
You feel nothing unexpected.

>play piano
You need to play specific notes.

>caged
That's not a verb I recognise.

>play caged
    *** From somewhere inside the piano, you hear a loud whirring noise, and the lights in the house begin to come on. Now that your surroundings are finally visible, you can see the piano splattered red, and standing behind you, is Ms. Light.

End. ***

Would you like to RESTART, RESTORE a saved game, QUIT or UNDO the last command?

* * *

>n
North room
You can't see much of the north room in this darkness. However, the floor is slick with a cold liquid. You have found a Wide Container in the middle of the room.

>x container
A wide, open container. It feels like it was made to be filled with something. It is empty. You can feel a handle on the wide container.

>open container
It isn't something you can open.

>take container
Taken.

>drop container
Dropped.

>x liquid
You can't see any such thing.

>d puddle
I only understood you as far as wanting to (go) d.

>x puddlw
You can't see any such thing.

>x puddle
A cold liquid lines the floor. It's slippery.

>take puddle
Taken.

>i
You are carrying:
  Puddle

>x floor
You can't see any such thing.

>s
Entrance Room
You have opened the front door and are in the house's first room. As you reach to the side of the door for the lights and flip the switch, you realize that the power must have gone out sometime during the storm. It's too dark to see, so you can't tell what the purpose of the room is. You need to find a way to turn the lights back on.

You know that in every house in your neighborhood there is usually a basement containing a back-up generator for power outages during storms like this one. If you can find the generator, it should be fairly simple to get the power back on. However, there might be a code or password needed to activate it.

For now, you can try navigate your way through the house by going North and East.

* * *

>smel room
That's not a verb I recognise.

>smell room
You can't see any such thing.

>smell entrance room
You can't see any such thing.

>listen entrance room
I only understood you as far as wanting to listen.

>listen to entrance room
You can't see any such thing.

>smell entrance room
You can't see any such thing.

>n
North room
You can't see much of the north room in this darkness. However, the floor is slick with a cold liquid. You have found a Wide Container in the middle of the room.

You can see Wide container here.

>smell
You notice an odd metallic smell coming from somewhere in the room.

>smell
You notice an odd metallic smell coming from somewhere in the room.

* * *

>smell
A faint smell of mildew lingers. You smell something else, too-- animal hair? It seems to be coming from a Large Object in the middle of the room.

>x object
Which do you mean, Large object or Hard object?

>large
A large object. It's hard to examine it using only sight in this darkness.

>touch large object
The large object is almost twice as big as you. It's soft and cushy. You bumped into a hard object next to the large object.

* * *

>x hard object
A large object. It's hard to examine it using only sight in this darkness.

>touch hard object
After examining the hard object through touch, you have discovered that it has a square, flat surface that is parallel to the ground. On the surface is a small box.

>take hard object
It's way too big.

>take large object
It's way too big.

>n
North room
You can't see much of the north room in this darkness. However, the floor is slick with a cold liquid. You have found a Wide Container in the middle of the room.

You can see Wide container here.

* * *

>smell
You notice an odd metallic smell coming from somewhere in the room.

>tough puddle
That's not a verb I recognise.

>touch puddle
Wet.

>touch container
You feel nothing unexpected.

>smell container
You smell nothing unexpected.

>x container
A wide, open container. It feels like it was made to be filled with something. It is empty. You can feel a handle on the wide container.

>x handle
You see nothing special about Handle.

>pull handle
Nothing obvious happens.

* * *

>e
East room
Going East, you travel down a flight of stairs. You assume that you must be in the basement. The generator should be in here somewhere.

>smell
You notice an odd metallic smell coming from somewhere in the room.

>touch
(Puddle)
Wet.

>listen
At first the room is completely silent. Then, out of nowhere you hear a single high-pitched sound coming from the middle of the room. It definitely sounds like a piano.

>x piano
After a quick search of the room, you find large piano resting solemnly in the center. From what you can tell, there is nothing else in the room.

>touch piano
You can easily find the the C-Key, D-Key, E-Key, F-Key, G-Key, A-Key, B-Key on the keyboard. With a brief brush of your fingertips, you can feel a sticky liquid on the keys.

You can play the piano by pressing one key at a time.

>touch keys
You can't see any such thing.

>play piano
That's not a verb I recognise.

>play c
That's not a verb I recognise.

>play c key
That's not a verb I recognise.

>play c-key
That's not a verb I recognise.

>press c
You can't see any such thing.

>press c key
You can't see any such thing.

>press c-key
You pressed the C-key and a note played.

>press a-key
You pushed the A key and a note played.

>press g-key
You pressed the G-key and a note played.

>press e-key
You pressed the E-Key and a note played.

>press d-key
You pressed the D-key and a note played.

* * *

>s
The front door won't seem to open! You were not given a key to the house, and you neither locked or unlocked the door when you first entered the house...

>s
The front door still won't open. You're trapped in here for now. All the more reason to get the lights back on as soon as possible.

>x ms light
You can't see any such thing.

* * *

>go in house
That's not something you can enter.

>house
That's not a verb I recognise.

>go in house
That's not something you can enter.

>walk
You'll have to say which compass direction to go in.

>examine
What do you want to examine?

>ms.light
Ms. Light's tiny house at the end of the culdesac looks about as decrepit and off-putting as she does. You are a bit nervous as you have never been inside before. Go North through Front Door and into Entrance Room.

What do you want to light?

>ms.light
This dangerous act would achieve little.

What do you want to light?

>walk n
Entrance Room
You have opened the front door and are in the house's first room. As you reach to the side of the door for the lights and flip the switch, you realize that the power must have gone out sometime during the storm. It's too dark to see, so you can't tell what the purpose of the room is. You need to find a way to turn the lights back on.

You know that in every house in your neighborhood there is usually a basement containing a back-up generator for power outages during storms like this one. If you can find the generator, it should be fairly simple to get the power back on. However, there might be a code or password needed to activate it.

For now, you can try navigate your way through the house by going North and East.

>examine
What do you want to examine?

>house
You can't see any such thing.

>examine room
You can't see any such thing.

>x entrance room
You can't see any such thing.

>l
Entrance Room
You have opened the front door and are in the house's first room. As you reach to the side of the door for the lights and flip the switch, you realize that the power must have gone out sometime during the storm. It's too dark to see, so you can't tell what the purpose of the room is. You need to find a way to turn the lights back on.

You know that in every house in your neighborhood there is usually a basement containing a back-up generator for power outages during storms like this one. If you can find the generator, it should be fairly simple to get the power back on. However, there might be a code or password needed to activate it.

For now, you can try navigate your way through the house by going North and East.

>n
North room
You can't see much of the north room in this darkness. However, the floor is slick with a cold liquid. You have found a Wide Container in the middle of the room.

>examine
What do you want to examine?

>wide container
A wide, open container. It feels like it was made to be filled with something. It is empty. You can feel a handle on the wide container.

>e
You can't go that way.

* * *

>e
East room
Going East, you travel down a flight of stairs. You assume that you must be in the basement. The generator should be in here somewhere.

>examine basement
You can't see any such thing.

>examine east room
I only understood you as far as wanting to examine east.

>examine east
You see nothing unexpected in that direction.

>look east
You see nothing unexpected in that direction.

>smell
You notice an odd metallic smell coming from somewhere in the room.

>use container
That's not a verb I recognise.

>activate container
That's not a verb I recognise.

>follow smell
That's not a verb I recognise.

>n
You can't go that way.

>s
You can't go that way.

>e
You can't go that way.

>w
Entrance Room
You have opened the front door and are in the house's first room. As you reach to the side of the door for the lights and flip the switch, you realize that the power must have gone out sometime during the storm. It's too dark to see, so you can't tell what the purpose of the room is. You need to find a way to turn the lights back on.

You know that in every house in your neighborhood there is usually a basement containing a back-up generator for power outages during storms like this one. If you can find the generator, it should be fairly simple to get the power back on. However, there might be a code or password needed to activate it.

For now, you can try navigate your way through the house by going North and East.

>e
East room
Going East, you travel down a flight of stairs. You assume that you must be in the basement. The generator should be in here somewhere.

* * *

>listen
At first the room is completely silent. Then, out of nowhere you hear a single high-pitched sound coming from the middle of the room. It definitely sounds like a piano.

>examine piano
Play something! (specific notes)

>a
That's not a verb I recognise.

>play a
You play a nice tune. Nothing else happens, though.

>play c
You play a nice tune. Nothing else happens, though.

>w
Entrance Room
You have opened the front door and are in the house's first room. As you reach to the side of the door for the lights and flip the switch, you realize that the power must have gone out sometime during the storm. It's too dark to see, so you can't tell what the purpose of the room is. You need to find a way to turn the lights back on.

You know that in every house in your neighborhood there is usually a basement containing a back-up generator for power outages during storms like this one. If you can find the generator, it should be fairly simple to get the power back on. However, there might be a code or password needed to activate it.

For now, you can try navigate your way through the house by going North and East.

* * *

>x large object
A large object. It's hard to examine it using only sight in this darkness.

>smell large object
The smell of mildew is overpowering.

>touch large object
The large object is almost twice as big as you. It's soft and cushy. You bumped into a hard object next to the large object.

>touch hard object
After examining the hard object through touch, you have discovered that it has a square, flat surface that is parallel to the ground. On the surface is a small box.

>touch small box
You can't see any such thing.

>touch box
You feel a small switch on the side of the box.

>touch switch
You feel nothing unexpected.

>smell switch
You smell nothing unexpected.

>press switch
Nothing obvious happens.

>flip switch
That's not a verb I recognise.

>pull switch
You flip the switch and you hear an audio recording being emitted from the box. The recording was low quality, and you strained to hear it. A bone-chilling music piece begins to play from what sounds like a piano. The unknown vocalist sings about drowning in a bathtub along to a sad melody. "Turn the faucet," the ghastly voice croons. Did Ms. Light compose this?

>e
East room
Going East, you travel down a flight of stairs. You assume that you must be in the basement. The generator should be in here somewhere.

>w
Entrance Room
You have opened the front door and are in the house's first room. As you reach to the side of the door for the lights and flip the switch, you realize that the power must have gone out sometime during the storm. It's too dark to see, so you can't tell what the purpose of the room is. You need to find a way to turn the lights back on.

You know that in every house in your neighborhood there is usually a basement containing a back-up generator for power outages during storms like this one. If you can find the generator, it should be fairly simple to get the power back on. However, there might be a code or password needed to activate it.

For now, you can try navigate your way through the house by going North and East.

* * *

>n
North room
You can't see much of the north room in this darkness. However, the floor is slick with a cold liquid. You have found a Wide Container in the middle of the room.

>touch container
You feel nothing unexpected.

* * *

>smell container
You smell nothing unexpected.

>touch wide container
You feel nothing unexpected.

>smell wide container
You smell nothing unexpected.

>taste wide container
You taste nothing unexpected.

>examine wide continer
I only understood you as far as wanting to examine Wide container.

>x wide container
A wide, open container. It feels like it was made to be filled with something. It is empty. You can feel a handle on the wide container.

>touch handle
You feel nothing unexpected.

>grab handle
That's not a verb I recognise.

>pull handle
Nothing obvious happens.

* * *

>w
You can't go that way.

* * *

>touch piano
You feel nothing unexpected.

>x piano
Play something! (specific notes)

>c a g e d
That's not a verb I recognise.

>c, a, g, e, d
You seem to want to talk to someone, but I can't see whom.

>play c, a, g, e, d
You play a nice tune. Nothing else happens, though.

>play caged
    *** From somewhere inside the piano, you hear a loud whirring noise, and the lights in the house begin to come on. Now that your surroundings are finally visible, you can see the piano splattered red, and standing behind you, is Ms. Light.

End. ***

Would you like to RESTART, RESTORE a saved game, QUIT or UNDO the last command?

* * *

>t
That's not a verb I recognise.

>touch
What do you want to touch?

>n
You must name something more substantial.

>north
Entrance Room
You have opened the front door and are in the house's first room. It's too dark to see, so you can't tell what the purpose of the room is.

>n
North room
There is a tiny button blinking a red light on what must be an electrical appliance hooked up to the wall.

>s
Entrance Room
You have opened the front door and are in the house's first room. It's too dark to see, so you can't tell what the purpose of the room is.

>touch
(Switch)
You feel nothing unexpected.

>large object
That's not a verb I recognise.

>touch
(Switch)
You feel nothing unexpected.

>box
That's not a verb I recognise.

>touch
(Switch)
You feel nothing unexpected.

>take box
That's fixed in place.

>touch
(Switch)
You feel nothing unexpected.

>touch large object
The large object is almost twice as big as you. It's soft and cushy. You bumped into a hard object next to the large object.

>feel
(Switch)
You feel nothing unexpected.

>touch room
You can't see any such thing.

>touch north room
I only understood you as far as wanting to touch north.

>s
Ms Light's Driveway
You were in need of a little bit of cash, and, though you were hesitant, agreed to house-sit for your mysterious old neighbor Ms. Light while she's out of town. It's storming tonight. You are currently getting rained on. Better get out of the rain right away. You can see Ms. Light's house.

>n
Entrance Room
You have opened the front door and are in the house's first room. It's too dark to see, so you can't tell what the purpose of the room is.

>touch entrance room
You can't see any such thing.

>x box
An object that's in the shape of a box. It's hard to examine it using only sight in this darkness.

On Box is Switch.

* * *

>n
Entrance-Room
 You have opened the front door and are in the house's first room. You turn on the light-switch, but the lights fail to come on. You realize that the power must have gone out sometime during the storm! It's too dark to see*, so you can't tell what's in the room or what it is used for. You need to find a way to turn the lights back on.

You know that in every house in your neighborhood there is usually a basement containing a back-up generator for power outages during storms like this one. If you can find the generator, it should be fairly simple to get the power back on. However, there might be a code or password needed to activate it.

*NOTE: It is very important to understand that the house is completely dark. You will not be able to obtain all clues and have a full game experience unless you use ALL/MOST OF YOUR SENSES to interact with each thing/room. Also: While it is possible to "smell" or "listen to" a room without specifying object, you cannot "feel" a room. You must "feel" or "touch" specified objects within a room. Smells and sounds of objects can also be different from the room they are located in.

You know that  North is North-Room and East is East-Room. South is Ms. Light's Driveway.

>smell
A faint smell of mildew lingers. You smell something else, too-- animal hair? You are sure Ms. Light does not own any pets... The smell seems to be coming from a Large-Object in the middle of the room.

>smell
A faint smell of mildew is coming from a Large-Object in the middle of the room.

>smell
A faint smell of mildew is coming from a Large-Object in the middle of the room.

>touch entrance-room
You can't see any such thing.

* * *

>take small-box
You shouldn't take any of Ms. Light's stuff. Who knows what she'd do to you if she noticed any of her things were missing!

>flip switch
You flip the switch and you hear an audio recording being emitted from the small-box. The recording was low quality, and you strained to hear it. A bone-chilling music piece begins to play from what sounds like a piano. The unknown vocalist sings about drowning in a bathtub along to a sad melody. "Turn the faucet," the ghastly voice croons. Did Ms. Light compose this?

>n
North-Room
You can't see much of the North-Room in this darkness. However, you immediately feel the floor is slick with a cold liquid. You have immediately found a long-container in the middle of the room.

South is Entrance Room.

>n
You can't go that way.

>s
Entrance-Room
You have opened the front door and are in the house's first room. As you reach to the side of the door for the lights and flip the switch, you realize that the power must have gone out sometime during the storm. It's too dark to see, so you can't tell what the purpose of the room is. You need to find a way to turn the lights back on.

You know that in every house in your neighborhood there is usually a basement containing a back-up generator for power outages during storms like this one. If you can find the generator, it should be fairly simple to get the power back on. However, there might be a code or password needed to activate it.

For now, you can try navigate your way through the house by going North and East.

>n
North-Room
You can't see much of the North-Room in this darkness. However, you immediately feel the floor is slick with a cold liquid. You have immediately found a long-container in the middle of the room.

South is Entrance Room.

>listen
You can hear a dripping noise coming from the long-container. Then, you hear the faint sound of quick-moving footsteps coming from another room in the house.

>listen
You can hear a dripping noise coming from the long-container. You no longer hear the strange footsteps, though.

* * *

>taste large-objects
You taste nothing unexpected.

>touch entrance-room
You can't see any such thing.

>feel entrance-room
You can't see any such thing.

>n
North-Room
You can't see much of the North-Room in this darkness.  However,  You immediately feel the floor is slick with a cold liquid. You have immediately found a long-container in the middle of the room.

South is Entrance-Room.

>touch north-room
You can't see any such thing.

* * *

>take hard-object
It's way too big.

>smell
A faint smell of mildew lingers. You smell something else, too-- animal hair? It seems to be coming from a Large Object in the middle of the room.

>smell large obect
You can't see any such thing.

>smell large-objects
The smell of mildew is overpowering.

>smell
A faint smell of mildew lingers. You smell something else, too-- animal hair? It seems to be coming from a Large Object in the middle of the room.

>x large-objects
Two large-objects. They're impossible to examine in this darkness. Remember to try all methods of examination.

>take box
You can't see any such thing.

>take small-box
Taken.

>take large-object
They're way too big.

>take small-box
You already have that.

* * *

>e
East-room
You travel down a flight of stairs and assume that you must be in the basement. The generator should be in here somewhere.

>e
You can't go that way.

>w
Entrance-Room
 North is North-Room and East is East-Room. South is Ms. Light's Driveway.

>e
East-room
You travel down a flight of stairs and assume that you must be in the basement. The generator should be in here somewhere.

>x piano
After feeling around the room, you find a large piano resting solemnly in the center. From what you can tell, there is nothing else in the room. Play something! (specific notes)

* * *

>e
East-room
You travel down a flight of stairs and assume that you must be in the basement. The generator should be in here somewhere.

>feel piano
You feel nothing unexpected.

>listen
At first the room is completely silent. Then, out of nowhere you hear a single high-pitched sound coming from the middle of the room. It definitely sounds like a piano.

>feel piano
You feel nothing unexpected.

>touch pinao
You can't see any such thing.

* * *

>e
East-room
You travel down a flight of stairs and assume that you must be in the basement. The generator should be in here somewhere.

>smell
You notice an odd metallic smell coming from somewhere in the room.

>touch
What do you want to touch?

>touch east room
I only understood you as far as wanting to touch east.

>touch east-room
You can't see any such thing.

>w
Entrance Room

>n
North-Room
You can't see much of the North-Room in this darkness. However, you immediately feel the floor is slick with a cold liquid. You have found a Wide Container in the middle of the room.

>x floor
The hard floor is covered in a puddle.

>x puddle
A puddle sits in in the middle of the floor. It's slippery.

>x puddle
A puddle sits in in the middle of the floor. It's slippery.

>x wide container
You can't see any such thing.

>feel long-container
You feel every inch of the long-container, and determine that it is deep enough to sit in. It's a bit damp on the inside, and you can assume that it was made to be filled with something. You can feel a knob on one end of the long container.

>e
You can't go that way.

>s
Entrance Room

>e
East-room
Going East, you travel down a flight of stairs. You assume that you must be in the basement. The generator should be in here somewhere.

>play CAGED
    *** From somewhere inside the piano, you hear a loud whirring noise, and the lights in the house begin to come on. Now that your surroundings are finally visible, you can see the piano splattered red, and standing behind you, is Ms. Light.

END. ***

Would you like to RESTART, RESTORE a saved game, QUIT or UNDO the last command?

* * *

>n
North-Room
You can't see much of the North-Room in this darkness.  However,  You immediately feel the floor is slick with a cold liquid. You have immediately found a long-container in the middle of the room.

South is Entrance Room.

>listen
You can hear a dripping noise coming from the long-container. Then, you hear the faint sound of quick-moving footsteps coming from another room in the house.

* * *

>listen
You can hear a dripping noise coming from the long-container. You no longer hear the strange footsteps, though.

>s
Entrance-Room
 The Entrance-Room. North is North-Room, East is East-Room, and South is Ms. Light's Driveway.

>n
North-Room
You can't see much of the North-Room in this darkness.  You immediately feel the floor is slick with a cold liquid. You have immediately found a long-container in the middle of the room.

South is Entrance Room.

>s
Entrance-Room
 The Entrance-Room. North is North-Room, East is East-Room, and South is Ms. Light's Driveway.

* * *

>s
The front door won't open! You were not given a key to the house, and you neither locked or unlocked the door when you first entered the house...

>s
The front door still won't open. You're trapped in here for now. All the more reason to get the lights back on as soon as possible.

* * *

>x ms light
Ms. Light is nowhere to be seen. She's probably left town by now.

>n
Entrance-Room
 You have opened the front door and are in the house's first room. You turn on the light-switch, but the lights fail to come on. You realize that the power must have gone out sometime during the storm! It's too dark to see*, so you can't tell what's in the room or what it is used for. You need to find a way to turn the lights back on.

You know that in every house in your neighborhood there is usually a basement containing a back-up generator for power outages during storms like this one. If you can find the generator, it should be fairly simple to get the power back on. However, there might be a code or password needed to activate it.

*NOTE: It is very important to understand that the house is completely dark. You will not be able to obtain all clues and have a full game experience unless you use ALL/MOST OF YOUR SENSES to interact with each thing/room. Also: While it is possible to "smell" or "listen to" a room without specifying object, you cannot "feel" a room. You must "feel" or "touch" specified objects within a room. Smells and sounds of objects can also be different from the room they are located in.

You know that  North is North-Room and East is East-Room. South is Ms. Light's Driveway.

>x ms light
You can't see any such thing.

>listen
You hear the muffled sound of the rain outside. Then, what sounds like music somewhere below you. Maybe you just imagined it.

>listen
You hear the muffled sound of the rain outside. You no longer hear any music.

>listen
You hear nothing unexpected.