Prologue:

Last night, while walking down the lonely sidewalk back to your house, you noticed several feet ahead of you was your neighbor, Ms. Light, sitting alone on a sidewalk bench. You had always felt sorry for the old woman (she looked about 100 years old), because she was both blind and a widow. You didn't know much else about her. Ms. Light had no friends, and she was always

Being blind, Ms. Light's eyes were always closed, and she was sitting so still she could have been asleep. Although you were walking as quitely as possible as to not disturb her, Ms. Light moved her head in your direction, acknowledging your presence. She had heard you from over 30 meters away! Maybe she had she smelled you? Or maybe she had sensed your presence, and knew that you had tried to avoid her? Wahtever it was, you had to admit that Ms. Light's ESP was more than a little creepy.

Before you could even say anything, Ms. Light uttered in a low, scratchy voice, "Ah, I've been waiting for you. I'm going out of town tomorrow night, and I need you to watch my house for me...

Lights Out
An Interactive Fiction by Lee-Won Fulbright
Release 1 / Serial number 141003 / Inform 7 build 6L38 (I6/v6.33 lib 6/12N) SD

Ms Light's Driveway
You were in need of a little bit of cash, and, though you were hesitant, agreed to house-sit for Ms. Light while she's out of town. It's storming tonight. You are currently getting rained on. Better get out of the rain right away. You can see Ms. Light's house.

>listen
You hear nothing unexpected.

>taste
What do you want to taste?

* * *

>t
That's not a verb I recognise.

* * *

>smell
You smell nothing unexpected.

>listen
You hear nothing unexpected.

* * *

>l
Ms Light's Driveway
You were in need of a little bit of cash, and, though you were hesitant, agreed to house-sit for your mysterious old neighbor Ms. Light while she's out of town. It's storming tonight. You are currently getting rained on. Better get out of the rain right away. You can see Ms. Light's house.

>listen
You hear nothing unexpected.

>listen to ms lights driveway
I only understood you as far as wanting to listen to Ms Light's house.

* * *

>n
Entrance Room
You have opened the front door and are in the house's first room. As you reach to the side of the door for the lights and flip the switch, you realize that the power must have gone out sometime during the storm. It's too dark to see, so you can't tell what the purpose of the room is. You need to find a way to turn the lights back on.

You know that in every house in your neighborhood there is usually a basement containing a back-up generator for power outages during storms like this one. If you can find the generator, it should be fairly simple to get the power back on. However, there might be a code or password needed to activate it.

For now, you can try navigate your way through the house by going North, East, and West.

>x house
You can't see any such thing.

>l house
You can't see any such thing.

>x ms light's house
You can't see any such thing.

>s
Ms Light's Driveway
You were in need of a little bit of cash, and, though you were hesitant, agreed to house-sit for your mysterious old neighbor Ms. Light while she's out of town. It's storming tonight. You are currently getting rained on. Better get out of the rain right away. You can see Ms. Light's house.

>x house
Ms. Light's one-story house at the end of the culdesac looks about as decrepit and off-putting as she is. You have never been inside before, so you're unfamiliar with the house's layout. Go North through Front Door and into Entrance Room.

>smell
You smell nothing unexpected.

* * *

>w
West room

>e
Entrance Room
You have opened the front door and are in the house's first room. As you reach to the side of the door for the lights and flip the switch, you realize that the power must have gone out sometime during the storm. It's too dark to see, so you can't tell what the purpose of the room is. You need to find a way to turn the lights back on.

You know that in every house in your neighborhood there is usually a basement containing a back-up generator for power outages during storms like this one. If you can find the generator, it should be fairly simple to get the power back on. However, there might be a code or password needed to activate it.

For now, you can try navigate your way through the house by going North, East, and West.

>e
East room
Going East, you travel down a flight of stairs. You assume that you must be in the basement. The generator should be in here somewhere.

* * *

>n
You can't go that way.

>listen
At first the room is completely silent. Then, out of nowhere you hear a single high-pitched sound coming from the middle of the room. It definitely sounds like a piano.

>x piano
A large piano rests solemnly in the middle of the room. From what you can tell, there is nothing else in the room.

* * *

>n
Living room
You have opened the front door and are in the house's living room. It's too dark to see.

You hear a faint sound coming from the basement. It is slowly but surely getting louder. Is it moving towards you? You have an urge to find the source of the sound.

Maybe you should try turn on the back up generator first before doing anything. You remember the generator is in the basement.

North of Living Room is the Kitchen, West is the Bathroom, and East is your parent's room.

>x first wall
You do not feel anything on the wall besides some cobwebs and picture frames.

>x picture frames
Just a bunch of old family photos.

* * *

>n
Living room
You have opened the front door and are in the house's living room. It's too dark to see.

You hear a faint sound coming from the basement. It is slowly but surely getting louder. Is it moving towards you? You have an urge to find the source of the sound.

Maybe you should try turn on the back up generator first before doing anything. You remember the generator is in the basement.

North of Living Room is the Kitchen, West is the Bathroom, and East is your parent's room.

>e
You can't go that way.

>w
West Wall
You feel nothing on the wall except for the door into the hallway. Best to look for the light switch before you go there.

You can see Hallway here.

>x hallway
The hallway leading to the bathroom, your parents" bedroom, and your own bedroom. It appears to be locked for some reason. It is west of West Wall

>w
(first opening Hallway)
It seems to be locked.

* * *

>n
Living room
You have opened the front door and are in the house's living room. It's too dark to see.

You hear a faint sound coming from the basement. It is slowly but surely getting louder. Is it moving towards you? You have an urge to find the source of the sound.

Maybe you should try turn on the back up generator first before doing anything. You remember the generator is in the basement.

North of Living Room is the Kitchen, West is the Bathroom, and East is your parent's room.

>n
Kitchen

>x pic
You can't see any such thing.

>x picture frames
Just a bunch of old family photos.

>x cobwebs
Gross!

* * *

>n
Kitchen

>x first wall
You can't see any such thing.

* * *

>n
Kitchen

>x front-wall
You can't see any such thing.

* * *

>n
Living room
You have opened the front door and are in the house's living room. It's too dark to see.

You hear a faint sound coming from the basement. It is slowly but surely getting louder. Is it moving towards you? You have an urge to find the source of the sound.

Maybe you should try turn on the back up generator first before doing anything. You remember the generator is in the basement.

North of Living Room is the Kitchen, West is the Bathroom, and East is your parent's room.

>w
Bathroom

>e
Living room
You have opened the front door and are in the house's living room. It's too dark to see.

You hear a faint sound coming from the basement. It is slowly but surely getting louder. Is it moving towards you? You have an urge to find the source of the sound.

Maybe you should try turn on the back up generator first before doing anything. You remember the generator is in the basement.

North of Living Room is the Kitchen, West is the Bathroom, and East is your parent's room.

>x pantry
You can't see any such thing.

>w
Bathroom

>w
You can't go that way.

>e
Living room
You have opened the front door and are in the house's living room. It's too dark to see.

You hear a faint sound coming from the basement. It is slowly but surely getting louder. Is it moving towards you? You have an urge to find the source of the sound.

Maybe you should try turn on the back up generator first before doing anything. You remember the generator is in the basement.

North of Living Room is the Kitchen, West is the Bathroom, and East is your parent's room.

>e
Parent's room
I'm not allowed to be in here. I won't look through their stuff.

>w
Living room
You have opened the front door and are in the house's living room. It's too dark to see.

You hear a faint sound coming from the basement. It is slowly but surely getting louder. Is it moving towards you? You have an urge to find the source of the sound.

Maybe you should try turn on the back up generator first before doing anything. You remember the generator is in the basement.

North of Living Room is the Kitchen, West is the Bathroom, and East is your parent's room.

>n
Kitchen
There's not much in here. A stove, a pantry, and a trashcan.

>x pantry
There is a knife here.

>take knife
Taken.

>x knife
A sharp knife.

>s
Living room
You have opened the front door and are in the house's living room. It's too dark to see.

You hear a faint sound coming from the basement. It is slowly but surely getting louder. Is it moving towards you? You have an urge to find the source of the sound.

Maybe you should try turn on the back up generator first before doing anything. You remember the generator is in the basement.

North of Living Room is the Kitchen, West is the Bathroom, and East is your parent's room.

>e
Parent's room
I'm not allowed to be in here. I won't look through their stuff.

>x room
You can't see any such thing.

>x parents room
You can't see any such thing.

>x parent's room
You can't see any such thing.

* * *

>n
Living room
You have opened the front door and are in the house's living room. It's too dark to see.

You hear a faint sound coming from the basement. It is slowly but surely getting louder. Is it moving towards you? You have an urge to find the source of the sound.

Maybe you should try turn on the back up generator first before doing anything. You remember the generator is in the basement.

North of Living Room is the Kitchen, West is the Bathroom, and East is your parent's room.

>x north wall
You do not feel anything on the wall besides some cobwebs and picture frames.

>x picture frames
Just a bunch of old family photos.

>e
You can't go that way.

>x e
You see nothing unexpected in that direction.

>l entry
You can't see any such thing.

>s
Front door
Your small blue house sits at the end of the culdesac. There are two levels as well as a basemement. There is a single large window. The front door is surprisingly open. North is the entrance to your house.

>x picture frames
You can't see any such thing.

* * *

>x
What do you want to examine?

>l
Entrance Room
You have opened the front door and are in the house's first room. It's too dark to see, so you can't tell what the purpose of the room is.

>s
Ms Light's Driveway
You were in need of a little bit of cash, and, though you were hesitant, agreed to house-sit for your mysterious old neighbor Ms. Light while she's out of town. It's storming tonight. You are currently getting rained on. Better get out of the rain right away. You can see Ms. Light's house.

* * *

>n
Entrance Room
You have opened the front door and are in the house's first room. It's too dark to see, so you can't tell what the purpose of the room is.

>smell
A faint smell of mildew lingers. You smell something else, too-- animal hair? It seems to be coming from a large object in the middle of the room.

>look under large object
You find nothing of interest.

>feel large object
The large object is almost twice as big as you. It's soft and cushy. You bumped into a hard object next to the large object.

>touch entrace room
You can't see any such thing.

>smell
A faint smell of mildew lingers. You smell something else, too-- animal hair? It seems to be coming from a large object in the middle of the room.

>follow smell
That's not a verb I recognise.

>x large object
A large object. It's hard to examine it using only sight in this darkness.

* * *

>smell large object
The smell of mildew is overpowering.

>smell large object
The smell of mildew is overpowering.

>take box
Taken.

>x button
You can't see any such thing.

>touch button carefully
You can't see any such thing.

>touch carefully button
You can't see any such thing.

>touch button
You can't see any such thing.

>touch box carefully
I only understood you as far as wanting to touch Box.

* * *

>smell
A faint smell of mildew lingers. You smell something else, too-- animal hair? It seems to be coming from a Large Object in the middle of the room.

* * *

>x object
Which do you mean, Large object or Hard object?

>x large object
A large object. It's hard to examine it using only sight in this darkness.

>x object
Which do you mean, Large object or Hard object?

>take large object
It's way too big.

>take box
Taken.

>x box
An object that's in the shape of a box. It's hard to examine it using only sight in this darkness.

>feel box
It's small enough to fit in your pocket.

>touch
(Box)
It's small enough to fit in your pocket.

>touch
(Box)
It's small enough to fit in your pocket.

>s
Ms Light's Driveway
You were in need of a little bit of cash, and, though you were hesitant, agreed to house-sit for your mysterious old neighbor Ms. Light while she's out of town. It's storming tonight. You are currently getting rained on. Better get out of the rain right away. You can see Ms. Light's house.

>t
That's not a verb I recognise.

>touch
(Box)
It's small enough to fit in your pocket.

>drop box
Dropped.

>touch
(Box)
It's small enough to fit in your pocket.