MyHouse
An Interactive Fiction by Lee-Won Fulbright
Release 1 / Serial number 140929 / Inform 7 build 6L38 (I6/v6.33 lib 6/12N) SD

Driveway
It's late, around 1 or 2 in the morning. It's storming outside. You just got home from a long day at your new job. Your parents" car is not there for some reason. From what you can see, there aren't any lights on inside your house. You are currently getting rained on. Your Front Door is North.

>x house
You can't see any such thing.

>n
House
Your small blue house sits at the end of the culdesac. There are two levels as well as a basemement. There is a single large window. The front door looks surprisingly uninviting.

* * *

MyHouse
An Interactive Fiction by Lee-Won Fulbright
Release 1 / Serial number 140929 / Inform 7 build 6L38 (I6/v6.33 lib 6/12N) SD

Driveway
It's late, around 1 or 2 in the morning. It's storming outside. You just got home from a long day at your new job. Your parents" car is not there for some reason. From what you can see, there aren't any lights on inside your house. You are currently getting rained on. Your Front Door is North.

>i
You are carrying:
  Keys

>n
House
Your small blue house sits at the end of the culdesac. There are two levels as well as a basemement. There is a single large window. The front door looks surprisingly uninviting.

* * *

MyHouse
An Interactive Fiction by Lee-Won Fulbright
Release 1 / Serial number 140929 / Inform 7 build 6L38 (I6/v6.33 lib 6/12N) SD

Driveway
It's late, around 1 or 2 in the morning. It's storming outside. You just got home from a long day at your new job. Your parents" car is not there for some reason. From what you can see, there aren't any lights on inside your house. You are currently getting rained on. Your Front Door is North.

>n
Front door
Your small blue house sits at the end of the culdesac. There is one level as well as a basemement. There is a single large window. The front door is surprisingly open. North is the entrance to your house.

>x window
You can't see any such thing.

* * *

>n
Front door
Your small blue house sits at the end of the culdesac. There is one level as well as a basemement. There is a single large window. The front door is surprisingly open. North is the entrance to your house.

>n
Living room
You have opened the front door and are in the house's living room. It's too dark to see.

You hear a faint sound coming from the basement. It is slowly but surely getting louder. Is it moving towards you? You have an urge to find the source of the sound.

Maybe you should try turn on the back up generator first before doing anything. You remember the generator is in the basement.

North of Living Room is the Kitchen, West is the Bathroom, and East is your parent's room.

>x first wall
You do not feel anything on the wall besides some cobwebs and picture frames.

>x picture frames
Just a bunch of old family photos.

* * *

>n
Living room
You have opened the front door and are in the house's living room. It's too dark to see.

You hear a faint sound coming from the basement. It is slowly but surely getting louder. Is it moving towards you? You have an urge to find the source of the sound.

Maybe you should try turn on the back up generator first before doing anything. You remember the generator is in the basement.

North of Living Room is the Kitchen, West is the Bathroom, and East is your parent's room.

>x front-wall
You can't see any such thing.

* * *

>n
Living room
You have opened the front door and are in the house's living room. It's too dark to see.

You hear a faint sound coming from the basement. It is slowly but surely getting louder. Is it moving towards you? You have an urge to find the source of the sound.

Maybe you should try turn on the back up generator first before doing anything. You remember the generator is in the basement.

North of Living Room is the Kitchen, West is the Bathroom, and East is your parent's room.

>x front wall
You can't see any such thing.

* * *

>n
Living room
You have opened the front door and are in the house's living room. It's too dark to see.

You hear a faint sound coming from the basement. It is slowly but surely getting louder. Is it moving towards you? You have an urge to find the source of the sound.

Maybe you should try turn on the back up generator first before doing anything. You remember the generator is in the basement.

North of Living Room is the Kitchen, West is the Bathroom, and East is your parent's room.

>e
You can't go that way.

>w
West Wall
You feel nothing on the wall except for the door into the hallway. Best to look for the light switch before you go there.

You can see Hallway here.

>x hallway
The hallway leading to the bathroom, your parents" bedroom, and your own bedroom. It appears to be locked for some reason. It is west of West Wall

>w
(first opening Hallway)
It seems to be locked.

* * *

>n
Living room
You have opened the front door and are in the house's living room. It's too dark to see.

You hear a faint sound coming from the basement. It is slowly but surely getting louder. Is it moving towards you? You have an urge to find the source of the sound.

Maybe you should try turn on the back up generator first before doing anything. You remember the generator is in the basement.

North of Living Room is the Kitchen, West is the Bathroom, and East is your parent's room.

>n
Kitchen

>x pic
You can't see any such thing.

>x picture frames
Just a bunch of old family photos.

>x cobwebs
Gross!

* * *

>n
Kitchen

>x first wall
You can't see any such thing.

* * *

>n
Kitchen

>x front-wall
You can't see any such thing.

* * *

>n
Living room
You have opened the front door and are in the house's living room. It's too dark to see.

You hear a faint sound coming from the basement. It is slowly but surely getting louder. Is it moving towards you? You have an urge to find the source of the sound.

Maybe you should try turn on the back up generator first before doing anything. You remember the generator is in the basement.

North of Living Room is the Kitchen, West is the Bathroom, and East is your parent's room.

>w
Bathroom

>e
Living room
You have opened the front door and are in the house's living room. It's too dark to see.

You hear a faint sound coming from the basement. It is slowly but surely getting louder. Is it moving towards you? You have an urge to find the source of the sound.

Maybe you should try turn on the back up generator first before doing anything. You remember the generator is in the basement.

North of Living Room is the Kitchen, West is the Bathroom, and East is your parent's room.

>x pantry
You can't see any such thing.

>w
Bathroom

>w
You can't go that way.

>e
Living room
You have opened the front door and are in the house's living room. It's too dark to see.

You hear a faint sound coming from the basement. It is slowly but surely getting louder. Is it moving towards you? You have an urge to find the source of the sound.

Maybe you should try turn on the back up generator first before doing anything. You remember the generator is in the basement.

North of Living Room is the Kitchen, West is the Bathroom, and East is your parent's room.

>e
Parent's room
I'm not allowed to be in here. I won't look through their stuff.

>w
Living room
You have opened the front door and are in the house's living room. It's too dark to see.

You hear a faint sound coming from the basement. It is slowly but surely getting louder. Is it moving towards you? You have an urge to find the source of the sound.

Maybe you should try turn on the back up generator first before doing anything. You remember the generator is in the basement.

North of Living Room is the Kitchen, West is the Bathroom, and East is your parent's room.

>n
Kitchen
There's not much in here. A stove, a pantry, and a trashcan.

>x pantry
There is a knife here.

>take knife
Taken.

>x knife
A sharp knife.

>s
Living room
You have opened the front door and are in the house's living room. It's too dark to see.

You hear a faint sound coming from the basement. It is slowly but surely getting louder. Is it moving towards you? You have an urge to find the source of the sound.

Maybe you should try turn on the back up generator first before doing anything. You remember the generator is in the basement.

North of Living Room is the Kitchen, West is the Bathroom, and East is your parent's room.

>e
Parent's room
I'm not allowed to be in here. I won't look through their stuff.

>x room
You can't see any such thing.

>x parents room
You can't see any such thing.

>x parent's room
You can't see any such thing.

* * *

>n
Living room
You have opened the front door and are in the house's living room. It's too dark to see.

You hear a faint sound coming from the basement. It is slowly but surely getting louder. Is it moving towards you? You have an urge to find the source of the sound.

Maybe you should try turn on the back up generator first before doing anything. You remember the generator is in the basement.

North of Living Room is the Kitchen, West is the Bathroom, and East is your parent's room.

>x north wall
You do not feel anything on the wall besides some cobwebs and picture frames.

>x picture frames
Just a bunch of old family photos.

>e
You can't go that way.

>x e
You see nothing unexpected in that direction.

>l entry
You can't see any such thing.

>s
Front door
Your small blue house sits at the end of the culdesac. There are two levels as well as a basemement. There is a single large window. The front door is surprisingly open. North is the entrance to your house.

>x picture frames
You can't see any such thing.

* * *

>n
Front door
Your small blue house sits at the end of the culdesac. There is one level as well as a basemement. There is a single large window. The front door is surprisingly open. North is the entrance to your house.

>open front door
You can't see any such thing.

* * *

>n
Front door
Your small blue house sits at the end of the culdesac. There is one level as well as a basemement. There is a single large window. The front door is surprisingly open. North is the entrance to your house.

>North
You can't go that way.

* * *

MyHouse
An Interactive Fiction by Lee-Won Fulbright
Release 1 / Serial number 140929 / Inform 7 build 6L38 (I6/v6.33 lib 6/12N) SD

Driveway
It's late, around 1 or 2 in the morning. It's storming outside. You just got home from a long day at your new job. Your parents" car is not there for some reason. From what you can see, there aren't any lights on inside your house. You are currently getting rained on. Your Front Door is North.

>x car
Your parents" old car. It appears locked.

>open car
It seems to be locked.

>n
Front door
Your small blue house sits at the end of the culdesac. There are two levels as well as a basemement. There is a single large window. The front door looks surprisingly uninviting.

>x window
It's pitch black inside. Everyone's probably asleep by now.

>open door
You can't see any such thing.

* * *

>x car
Your parents" old car. It appears locked.

>x toyota
You can't see any such thing.

>n
House
Your small blue house sits at the end of the culdesac. There are two levels as well as a basemement. There is a single large window. The front door looks surprisingly uninviting.

* * *

>x car
Your parents" old car. It appears locked.

>x house
You can't see any such thing.

* * *

MyHouse
An Interactive Fiction by Lee-Won Fulbright
Release 1 / Serial number 140929 / Inform 7 build 6L38 (I6/v6.33 lib 6/12N) SD

Driveway
It's late, around 1 or 2 in the morning. It's storming outside. You just got home from a long day at your new job. Your parents" car is not there for some reason. From what you can see, there aren't any lights on inside your house. You are currently getting rained on. Your Front Door is North.

>x toyota
Your parents" old car. It appears locked.

>open toyota
It seems to be locked.

* * *

MyHouse
An Interactive Fiction by Lee-Won Fulbright
Release 1 / Serial number 140929 / Inform 7 build 6L38 (I6/v6.33 lib 6/12N) SD

Driveway
It's late, around 1 or 2 in the morning. It's storming outside. You just got home from a long day at your new job. Your parents" car is not there for some reason. From what you can see, there aren't any lights on inside your house. You are currently getting rained on. Your Front Door is North.

>enter house
You can't see any such thing.